5000000000000000000001
5000000000100000000001
500000000000000x000001
5000000000200000000001
5000000000000000000001
6000000000300000000002
6000000000000000000002
6000000000400000000002
6000000000000000000002
6000000000500000000002
7000000000000000000003
7000000000600000000003
7000000000000000000003
7000000000700000000003
7000000000000000000003
8000000000800000000004
8000000000000000000004
8000000000000000000004
8000000000000000000004
8000000000000000000004
